+------------------------------+------------------------------+---------+
|  💩💩  💩  💩  💩      💩 |  💩  💩  |            💩💩   💣 |   💩   💩  |  💩  💩💩 ♥|  coin:    
|💩💩💩💩    💩   💩  💩💩    |     💩  | 💩  💩 💩    💩  💩💩   |       💩      💩 💩💩💩 |  poo:   
|💩  💩    💩    💩   💩  💩💩 💩 💩    | 💩 💩 💩♥ 💩    💩 💩 💩 |   💩      | 💩  💩 💩  |  star:  
|  💩   💩   💩    💩     |      💩 |    💩 💩💩   💩    💩 💩|💣      💩  |   💩 💩💩  |  life:  
+--💩---+-----💩-------------💩------ ----------------------- ---------💩---+
|   💩  |  💩     💩     |  💩     | 💩    💩💩  💩💩      💩| 💩  💩  💩  |   💩     |
| 💩 💩  | 💩  💩  💩   💩  | 💩  💩   |    💩 💩♥💩    💩💩    |   💩  💩   | 💩   💩   |
|💩   💩 |     💩 💩  💩   |   💩  💩    💩   💩💩 💩  💩   💩  |  💩      💩|   💩   💩 |
|  💩   |   💩        💩 |        | 💩  💩         💩    ------💩----------+  💩|
+-- ---------💩--------------------------------- ---+  💩       |💣💩  💩|   |
|  💩   | 💩 💩   💩      |💣       |  * 💩   |  💩   💩   |  💩  💩  💩 |   💩 | 💩 |
| 💩 💩  💩 💩    💩♥💩💩    |   💩  💩 |  💩  💩     💩  💩    |   💩  💩   |  💩  |   |
|  💩   |   💩   💩    💩 |  💩     | 💩      |💩    💩  💩 | 💩      💩 |💩💩 💩 | 💩 |
|--💩---|--------------|-💩------|--- ----|----------+   💩💩💩    |💩  💩 |   |
|      |              |    💩   |   💩    |  💩  💩    💩 💩 💩   💩  | 💩 💩 | 💩 |
| 💩  💩 |   💩 💩     💩  | 💩     💩       💩 | 💩  💩  💩   💩      💩  |💩💩   |   |
|-- ---|-----------------------+   💩    |  💩 💩    💩   💩 💩     | 💩 💩 | 💩 |
|      |          💩           💩     💩   |            💩   💩    |  💩  💩   |
|💩   💩 |     💩        |   💩       💩     |  💩 💩  💩 💩 💩   💩     | 💩  💩|   |
+--- --|--------💩-----------------------|------ ----------------- --|---+
| 💩 💩  💩   💩       💩  |   💩          💩                    💩   |   💩     |
|  💩   |     💩  💩     💩     💩💩 💩 💩      |   💩   💩     💩       | 💩   |   |
+------+--------------+-----------------+---------------------------+---+
